#########################################################
#########################################################
##@...................................................@##
##.###.###################.##############.##.%%.##.###.##
##.###.###################.##############.##.%%.##.###.##
##.###....................................##.%%.##.###.##
##.###.%%%%%%%%.##########.%%.%%.########.##.%%.##.###.##
##.###.%%%%%%%%.##########.%%.%%.########.##.%%.##.###.##
##.....%%    %%.##########.%%.%%.............%%........##
######.%%    %%            %%.%%.%%%%%%%%.%%%%%%%%.######
######.%%%%%%%% %%%%-*%%%% %%.%%.%%%%%%%%.%%%%%%%%.######
L     .%%%%%%%% %%%%--%%%% %%.%%.%%    %%....%%....     R
######.%%%%%%%% %%      %% %%.%%.%%%%%%%%.##.%%.##.######
######.%%    %% %%-*-*-*%% %%.%%.%%%%%%%%.##.%%.##.######
##.....%%    %% %%      %% %%.%%.%%.......##.%%.##.....##
##.###.%%%%%%%% %%%%%%%%%% %%.%%.%%%%%%%%.##.%%.##.###.##
##.###.%%%%%%%% %%%%%%%%%% %%.%%.%%%%%%%%.##.%%.##.###.##
##@............      $     ...........................@##
#########################################################
#########################################################
